############################
#            ##            #
# #### ##### ## ##### #### #
#O#### ##### ## ##### ####O#
# #### ##### ## ##### #### #
#                          #
# #### ## ######## ## #### #
# #### ## ######## ## #### #
#      ##    ##    ##      #
###### ##### ## ##### ######
     # ##### ## ##### #
     # ##          ## #
     # ## ###  ### ## #
###### ## #      # ## ######
#         #      #         #
###### ## #      # ## ######
     # ## ######## ## #
     # ##          ## #
     # ## ######## ## #
###### ## ######## ## ######
#            ##            #
# #### ##### ## ##### #### #
# #### ##### ## ##### #### #
#O  ##                ##  O#
### ## ## ######## ## ## ###
### ## ## ######## ## ## ###
#      ##    ##    ##      #
# ########## ## ########## #
# ########## ## ########## #
#                          #
############################